######################
#....................#
#....##....##........#
#....##....##........#
#....................#
#....##....##........#
#....##....##........#
#....................#
######################
